 
C     9, 	89, 	150
	WE ./textures/west.xpm
 NO ./textures/north.xpm
  SO   ./textures/south.xpm
EA ./textures/east.xpm

F 26, 23, 37



1111111111111111111111111
1000000000110000000000001
1011000001110000000000001
1001000000000000000000001
1111111110110000011100001
100000000011000001110001111111111
11110111111111011100000010001
11110111111111011101010010001
11000000110101011100000010001
10000000000000001100000000001
100N0000000000001101010000001
11000001110101011111011110001
11110111 1110101 101111010001
11111111 1111111 111111111111
